%%%%%%%%%%%%%%%%%%%%%%%%%%%%%%%%%%%%%%%%%%%%%%%%%%%%%%%%%%%%
%..........%%..................................%%..........%
%..........%%..................................%%.        .%
%..%%%%%%%%%%..%%%%%%%%%%%%%%%%%%%%%%%%%%%%%%..%%.        .%
%..%%%%%%%%%%..%%%%%%%%%%%%%%%%%%%%%%%%%%%%%%..%%.        .%
%..%%......%%..%%............%%............%%..%%.        .%
%..%%......%%..%%............%%............%%..%%.....    .%
%......%%%%%%..%%..%%%%%%%%%%%%..%%%%%%%%......%%%%%%.    .%
%......%%%%%%..%%..%%%%%%%%%%%%..%%%%%%%%......%%%%%%......%
%%%%%..%%..%%..%%..%%............%%....%%..%%......%%..%%%%%
%%%%%..%%..%%..%%..%%............%%....%%..%%......%%..%%%%%
%......%%..%%%%%%..%%..%%%%%%..%%%%%%..%%..%%%%%%..%%......%
%......%%..%%%%%%..%%..%%%%%%..%%%%%%..%%%%%%%%%%..%%......%
%..%%%%%%..............%%..........%%..............%%%%%%..%
%..%%%%%%..............%%..........%%..............%%%%%%..%
%......%%..%%%%%%%%%%..%%%%%%%%%%%%%%%%%%..%%%%%%..%%......%
%......%%..%%%%%%%%%%..%%%%%%%%%%%%%%%%%%..%%%%%%..%%......%
%%%%%..%%......%%..%%........%%........%%..%%......%%..%%%%%
%%%%%..%%......%%..%%........%%........%%..%%......%%..%%%%%
%......%%%%%%..%%..%%%%%%%%%%%%..%%%%%%%%%%%%..%%%%%%..%%..%
%.    .%%%%%%..%%..%%%%%%%%%%%%..%%%%%%%%%%%%..%%%%%%..%%..%
%.    .........%%............%%............%%..........%%..%
%.        .....%%............%%............%%..........%%..%
%.        .%%..%%%%%%..%%%%%%%%%%%%%%..%%%%%%..%%..%%%%%%..%
%.        .%%..%%%%%%..%%%%%%%%%%%%%%..%%%%%%..%%..%%%%%%..%
%.        .%%..........................%%......%%..........%
%..........%%.................P........%%......%%..........%
%%%%%%%%%%%%%%%%%%%%%%%%%%%%%%%%%%%%%%%%%%%%%%%%%%%%%%%%%%%%
