%%%%%%%%%%%%%%%%%%%
%.............%...%
%.           .%. .%
%. ......... .%. .%
%. .%%%%%%%. .%. .%
%. .......%. .%. .%
%.     P .%. .%. .%
%.........%. .%. .%
%%%%%%%%%%%. .%. .%
%........... ... .%
%.           ... .%
%.............%...%
%%%%%%%%%%%%%%%%%%%