%%%%%%%%%%%%%%%%%%
%.............%%%%
%.           .%%%%
%.           .%%%%
%.           ....%
%.              .%
%.              .%
%.           ....%
%.           .%%%%
%.   ..... P .%%%%
%.....%%%.....%%%%
%%%%%%%%%%%%%%%%%%