%%%%%%%
%.....%
%.   .%
%. P .%
%.   .%
%.....%
%%%%%%%
